sokoranya nuwo murikumwe = izuru n'umunwa
ndakibona sindagifata = igitutu
icutabonye = ubukumi bwa so na nyoko
ikiri kure kiry'abari n'amaguru = ikigazi
mpa utwo mbona = utuboga kumenyo
karinungereye = akotsi kabungere
aho hepfo haciye ingo itavuga = umugore afise inda
aho hepfo haciye haciye ivyiza gusa = patiri na musenyeri
impuuu!!! = igikamiwe make
karadiridimvye = akana kajiwabo
karasimvye miheneko = agahene gasimba umugezo
so na nyoko bapfuyiki = umwungu wo murubibe
ndakibona sindagifata = igitutu
ndavye kwamabukwe mbona harera = agafu kumbuga
umututsi muremure yavuye imagamba = ima ry'imvura
aho hepfo haciye impehe nsa = ingabo zitangira umutware
umugozi utekera amazi = ifu
akana kanje ko kunesha mutangana = uruyuki
mvuye guta mama agaruka arankurikira = umwavu
ane meza =  amabere y'inka
umunani mubi = amabere y'imbwa
mbe sokuru kuseye bwinshi uri kujahe = itimbi ry'ifuku
fata isuka nanje mfate iyindi tuje kurondera ico tutabona = umuzi wibuye
ndavye hejuru ndanungwa = umuhwi kurusenge
kubita binati ntiyota arasara = urubumbiro
gira so katamobwa = agahanga kimbwa
ipiri gipimpi = igisuzi c'inkumi
tora ishoka nanje ntore iyindi tuje guhiga ico tutabona = amaganga y'inkoko
baransasira sinryama = ikawa
ndara mpagaze bwaca nkaryama = imyugariro
ndara ndagenda nkirirwa ndagenda = uruzi
ehe urya musozi wishika ibikanu = abahizi
ehe urya mukecuru ansimbiye urugo = ikivumvuri